05 01 01 01 01 01 01 01 01 01 01 01 01 01 01 01 01 01 01 01 01 01 01 01 06
04 17 02 02 02 02 02 02 02 02 02 02 17 02 02 02 02 02 02 02 02 02 02 17 03
04 03 00 00 00 00 00 00 00 00 00 00 03 11 12 13 14 00 00 00 15 15 19 04 03
04 03 00 20 00 00 20 00 00 20 00 00 03 00 00 00 00 00 00 00 00 00 00 04 03
04 03 00 00 00 00 00 00 00 00 00 00 08 18 00 00 16 16 16 16 16 16 00 04 03
04 03 00 00 00 00 00 00 00 00 00 00 00 00 00 00 16 16 00 00 00 00 00 04 03
04 03 00 20 00 00 20 00 00 20 00 00 00 00 00 00 16 16 00 00 00 00 00 04 03
04 03 00 00 00 00 00 00 00 00 00 00 06 00 00 00 16 16 00 00 00 00 00 04 03
04 03 00 00 00 00 00 00 00 00 00 00 03 10 00 00 16 16 00 00 00 00 09 04 03
04 03 00 20 00 00 20 00 00 20 00 00 03 00 00 00 00 00 00 00 00 00 00 04 03
04 03 00 00 00 00 00 00 00 00 00 00 03 10 00 00 00 00 00 00 09 00 09 04 03
04 17 01 01 01 01 01 01 01 01 01 01 17 01 01 01 01 01 01 01 01 01 01 17 03
07 02 02 02 02 02 02 02 02 02 02 02 02 02 02 02 02 02 02 02 02 02 02 02 08